### Properties ###
player:X
title:The_Cave_Map
background:http://www.techcredo.com/wp-content/uploads/2010/06/Ibex_Wallpaper_by_willwill100.png
foreground:#ffffff
###    Map     ###
# Breite der Map der erste "-" wird nicht mit gezählt.
----------------------------------------------------------------------------------------------------------------------------------------------------------
# Eine Zeile der Map beginnt immer mit einem ":",
# danach können beliebige Zeichen des deutschen Alphebetes benutzt werden.
:                                                                                                      b      b             b          b
:                                                                                                DDDDDDDDDDDDDDDDDDDDDDDDDDDDDDDDDDDDDDDDDDDDD
:_______     BBB            BBB                  BBB                                            DGGGGGGGGGGGGGGGGGGGGGGGGGGGGGGGGGGGGGGGGGGGGG
:_______\   BBBBB          BBBBB                BBBBB                     b                 b DDGGTTTTTTTTTTTTTTTTTTTTTTTTTTTTTTTTTTTTTTTTTTTT
:       |   BBBBB          BBBBB                BBBBB                   DDDD        ________DDGGTTTTTTTT            VNV           TTTTTTTTTTTT
:       |     i              i          b         i                     GGGG       /________IGITTT   V               V            v  TTTTTTTTT
: X     i     i     b        i       DDDD         i    b                GIIG       |        III                                        TTTTTTT
:HHHHHHHHDDDDDDDDDDDDDDDDDDDDDDDDDDDDGGGGDDDDDD  DDD  DDDD   DDDD    DDDGIIG       |        omz                                           TTTT
:TTTTTTTTTGGGGGGGGGGGGGGGGGGGGGGGGGGGGGGGGGGGGI^^IGI^^IGGI^^^IGGI    IIIIGII       i    u u TTT                                           IIII
:IIOIIIIIIIIIIIOIIIIIIIIIIIIIIIIIIIIIIIIIIIIIIIIIIIIIIIIIIIIIIIII    IIIOIII  #ZZZTHHHHHHHHHIII          b                  b           ^^IIII
:IIIII          VNv  v    v    vIII     V   vv        V    v         IIIIIII  #   IIIIIIIIIIIIITTTTTTTTTTTTTTTTTTTT   TTTTTTTTTTTTTTTTTTTTIIII
:III             V              v                                    IGIIIII  #   IIIIIIIIIOIIIIIIIIIIIIIIIIIIIIIII   IIIIIIIIIIIIIIIIIIIIIIII
:II             *               *                   *                IIIIIII  #   IIIIOIIIIIIIIIIOIIIIIIIIOIIIIIIII   IIIIIIIOIIIIIIIIIIIIIIII
:II                  *                        #                  TTTTIIIIIII  #   IIIIIIIIIIIIIIIIIIIIIIIIIIIIIIIII   IIIIIIIIIIIIIIIIIIIIIIII
:IIT                                    *                   TTTTTIIIIIOIIIII  #   IIIIIIIIIIIIIIIIIIIII   Vv              v  V    IIIIIIIIIIII
:IIITTTTTTTT   TTTTTTTTTTTTTTTTTTT   TTTTTT      TTTTTTTTTTTIIIIIIIIITTTIIII  #   IIIIIIIIIIOIIIIII  V                             v  IIIIIIII
:IIIIIIIIIII   IIIIIIIIIIIIIIIIIII^^^IIIIII^^^^^^IIIIIIIIIIIIIIIIOIIIIIIIIII  #   IIIIIIOIIIIIIII          *                            IIIIII
:IIIIIIIIIII   IIIIIIIIIIIIIIIIIIIIIIIIIIIIIIIIIIIIIIIIIIIIOIIIIIIIIIIIIIIII  #   IIIIIIIIIIIIII                     b                   IIIII
:IIIIII	v               Vv      IIIIIIIIIIIIIIIIIIIIIIII                      #   IIIIIIIIIIIII                  TTTTTTT     *            IIII
:III                                            IIIIIIII ##TTTTTTTTTTTTTTT    #   IIIIIOIIIIIII           *      \  U  /                  IIII
:III                                                 II  # IIIIIIIIIIIIIOITT  #   IIIIIIIIIIIII                   \ U /            *      IIII
:IIITTTTTTTTTTTTTTT                                      #      IIIIIIIIIIII  #   IIIIIIIIIIIII      *              U                     IIII
:IIIIIIIIIIIIIIIIIITTTTTT                                #                    #   IIIIIIII                          U                     IIII
:IIOIIIIIIIIIIIIIIIIIIIII    TT   TT    ___     ___     ___                   #   IIIOIIII#IIIIT              ^ ^ ^ U ^ ^ ^               IIII
:IIIIIIIIIOIIIIIIIIIIIIII^^^^II^^^II   //i\\   //i\\   //i\\          #   #   #   IIIIIIII#IIII/            TTTTTTTTTTTTTTTTT             IIII
:IIIIIIIIIIIIIIIIIIIIIIIIIIIIIIIIIII     i       i       i         #          #   IIIIIIII#IIII              \\IIIIIIIIIII//              IIII
:IIIIIIIIIIIIIIIIIIOIIIIIIIIIIIIIIII     i       i   b   i                    #   IIIIIIII#IIII               \| +  I  + |/  *            IIII
:IIIIIOIIIIIIIIIIIIIIIIIIIIIIIIIIIIITTTTTTTTTTTTTTTTTTTTTTTTTTTTT    rekt   TTTTTTIIIIOIII#IIII      *      #  |    +    |  #             IIII
:IIIIIIIIIIIIIIIIIIIIIOIIIIIIIIIIIIIIIIIIIIIIIIIIIOIIIIIIIIIIIIII^^^^^^^^ ^^IIIIIIIIIIIIII#IIII                                           IIII
:IIIIIIIIIIIIOIIIIIIIIIIIIIIIWIIIOIIIIIIIOIIIIIIIIIIIIIIIIIIIIIIIIIIIIIII IIIIIOIIIIIIIIOI#IIIIT              #           #               IIII
:IIIIIIIIIIIIIIIIIIIIIIIIIIIIIIWIIWWIIIWWWWIIIIIIIIIIIIIIIIIIOIIIIIIIIIII IIIIIIIIIIIIIIII#IIII^^^^^^^^^^^^^^^^TTTTT TTTTT^^^^^^^^^^^^^^^^IIII
:IIIIIIOIIIIIIIIIIIIIIIIIIIIIIIIIIIWWWWWIIWWWIIIWIIOIIIIIIIIIIIIIIIIIIIII  you still suck #IIIIIIIIIIIIIIIIIIIIIIIII IIIIIIIIIIIIIIIIIIIIIIIII
:IIIIIIIIIIIIIIIIIIIIIIIIIIIIIIIIIWIIIWIIIIIIWWIIIIIIIIIIIIIIIIIIIIIIIIII                 #      IIIIIIIIIIIIIIIIIII IIIIIIIIIIIIIIIOIIIIIIIII
:IIIIIIIIIIIIIIIIIIOIIIIIIIIIIIWIIIIIIWWWWWWIIIIIIIIIOIIIIIIIIIIIIIIIIIIIIITTTTTTTTTTTTTTTTIIII# II  v IIIIIII  v            Vv      IIIIIIITT
:IIIIIIIIIIIIIIIIIIIIIIIIIIIIIIIIIIIIIIIIOIWIIWIIIIIIIIIIIIIIIIIIIOIIIIIIIIIIIIIIIIIIIIIIIIIIII#         III                            IIIIII
:IIIIIIIIIOIIIIIIIIIIIIIIIIOIIIIIIIIIIIIIIIWWWIIIIIIIIIIIIIIIIIIIIIIIIIIIIIIIIIOIIIIIIIIIIIIIII#     *   III                  *          IIIII
:IIIIIIIIIIIIIIIIIIIIIIIIIIIIIIIIIIIIIIIIIIWIIIIIIIIIIIIIIIIIIIIIIIIIIIIIIIIIIIIIIIIIIIIIIIIIII#         II     *                        IIIII
:IIIIIIIIIIIIIIIIIIIIIIIIIIIIIIIIIIIIIIIIIIIIIIIIIOIIIIIIIIIIIIIIIIIIIIIIIIIIIIIIIIIIIIIIIIIIIIII    ^IIIII                  *            IIII
:IIIIIIIIIIIIIIIIIIIIIIIIIOIIIIIIIIIIIIIIIIIIIIIIIIIIIIIIIIIIIIIIIIIOIIIIIIIIIIIIIIIIIIIIIIIIIIIIIIIIIIIIII                               IIII
:IIIIIIIIIIIIIIIIIIIIIIIIIIIIIIIIIIIIIIIIIIIIIIIIIIIIIIIIIIIIIIIIIIIIIIIIIIIIIIIIIIIIIIIIIIIIIIIIIIIIIOIIIITT        *                  TTIIII
:IIIIIIIIIIIIIIIIIIIIIIIIIIIIIIIIIIIIIOIIIIIIIIIIIIIIIIIIIIIIIIIIIIIIIIIIIIIIIIIIIIIIOIIIIIIIIIIIIIIIIIIIIIIITTTTTTTTTTTTTTTTTTTTTTTTTTTIIIIII
:IIIIIIIIIIIIIOIIIIIIIIIIIIIIIIIIIIIIIIIIIIIIIIIIOIIIIIIIIIIIIIIIIIIIIIIIIOIIIIIIIIIIIIIIIIIIIIIIIIOIIIIIIIIIIIIIIIIIIIIIIIIIIIIIIIIIIIIIIIOII
:IIIIIIIIIIIIIIIIIIIIIIIIIIIIIIIIIIIIIIIIIIIIIIIIIIIIIIIIIIIIOIIIIIIIIIIIIIIIIIIIIIIIIIIIIIIIIIIIIIIIIIIIIIIIOIIIIIIIIIIIIIIIIIIIIOIITIIIIIIII
:IIIIIIIIIIIIIIIIIIIIIIIIIIIIIIIIIIIIIIIIIIIIIIIIIIIIIIIIIIIIIIIIIIIIIIIIIIIIIIIIIIIIIIIIIIIIIIIIIIIIIIIIIIIIIIIIIIIIIIIIIIIIIIIIIIIIIIIIIIIII


### Events ###
## Syntax ##
# Ein Event beginnt immer mit einer Tilde(~), danach die Koordinaten zwischen denen das Event ausgeführt wird (TriggerArea).
# Nun folgt der Name des Events(Type).
# Jetzt folgen die Paramter, diese sind von Typ zu Typ unterschiedlich.
# Bei Parametern sind auch "Texte mit Leerzeichen" erlaubt.
#
# TriggerArea:
#    x1.y1;x2.y2
#    x.y
#    Die TriggerArea ist die Fläche zwischen dem Punkt1(x1,y1) und dem Punkt2(x2, y2) oder nur der Punkt(x, y)
# Type:
#    display, checkpoint, end, style, teleport, set_condition, if_condition
#
# Mögliche Parameter:
#    display:
#        message (string) HTML ist erlaubt
#        dauer der Anzeige in ms (int)
#    checkpoint:
#        Koordinaten des Checkpoints (x.y)
#        Soll eine nachricht angezeigt werden (boolean)
#    end:
#        typ (finish)
#    style:
#        background (url, htmlColor)
#        foreground (htmlColor) nur im Editor modus verfügbar
#    teleport:
#        Koordinaten des Zieles (x.y)
#    set_block:
#        zu setzende Char
#        Koordinaten des zu setzenden Blocks (x.y)
#    set_condition:
#        key der Bedingung (string)
#        wert der Bedingung (string)
#    if_condition:
#        key der Bedingung (string)
#        sollwert der Bedingung (string)
#        hinter dem "->" ein event schreiben
#
## Beispiele ##
#~7.6 display "Welcome to\n <b>THE CAVE MAP</b>\n by Maik Müller" 1000
#~56.14;48.14 checkpoint 55.14 true
#~8.6 setblock | 7.6
#~6.6 style http://www.example.com/image.jpg #ffffff
#~8.6 set_condition schlüssel1 true
#~15.6 if_condition schlüssel1 true -> setblock | 7.6
#~115.32 end finish
#
### Conditions ###
## Syntax ##
# Eine Condition beginnt mit "* condition" danach folgt der key der Condition und der Start-Wert
## Beilspiel ##
#* condition schlüssel1 false
### END ###

~6.6 style http://www.techcredo.com/wp-content/uploads/2010/06/Ibex_Wallpaper_by_willwill100.png #ffffff
~7.6 display "Welcome to\n <b>THE CAVE MAP</b>\n by Maik Müller" 1000
~8.6 style http://img02.deviantart.net/63b1/i/2013/261/d/e/cave_by_boneswolbach-d6muz3x.png #ffffff
~83.8 style http://www.techcredo.com/wp-content/uploads/2010/06/Ibex_Wallpaper_by_willwill100.png #ffffff
~82.8 style http://img02.deviantart.net/63b1/i/2013/261/d/e/cave_by_boneswolbach-d6muz3x.png #ffffff
~93.7 style http://www.techcredo.com/wp-content/uploads/2010/06/Ibex_Wallpaper_by_willwill100.png #ffffff
~94.7 style http://img02.deviantart.net/63b1/i/2013/261/d/e/cave_by_boneswolbach-d6muz3x.png #ffffff
~56.14;48.14 checkpoint 55.14 true
~23.21;23.18 checkpoint 23.21 true
~82.8 checkpoint 82.8 true
~114.10;116.10 checkpoint 115.10 true
~115.32 end finish