player:X
----------------
:
:
:###############
:#             #
:#             #
:#             #
:#    X   MMMMM#
:###############